#################################
## #### ### #### #### ### #### ##
#                               #
## #### ### #### #### ### #### ##
## ############# ############# ##
## ############# ############# ##
#   ###########   ###########   #
## ############# ############# ##
## ############# ############# ##
## ############# ############# ##
#   ###########   ###########   #
## ############# ############# ##
## #### ### #### #### ### #### ##
#                               #
## #### ### #### #### ### #### ##
#################################